1111112111
1222212121
1211112121
1212222111
1211111121
1222122221
1112111121
1212222121
1212111121
@21112222#