@222222222
1222222222
1211111112
1212222212
1*12111212
2221121212
1111221*12
1222222222
*11111*112
22222222#2